//MAP CONVERTED BY dmm2tgm.py THIS HEADER COMMENT PREVENTS RECONVERSION, DO NOT REMOVE
"aw" = (
/obj/structure/table/bronze,
/obj/machinery/light/directional/north,
/obj/item/toy/figure/wizard{
	pixel_x = 4
	},
/obj/item/toy/figure/ninja{
	pixel_x = -7;
	pixel_y = 10
	},
/turf/open/floor/carpet/nanoweave/blue,
/area/ship/bridge)
"az" = (
/obj/structure/window/bronze{
	dir = 4
	},
/obj/structure/window/bronze,
/turf/open/floor/carpet/nanoweave/red,
/area/ship/bridge)
"aA" = (
/obj/machinery/computer/cargo/express{
	pixel_y = 9;
	pixel_x = 5
	},
/turf/open/floor/carpet/nanoweave/blue,
/area/ship/bridge)
"aW" = (
/obj/machinery/computer/camera_advanced/syndie{
	pixel_y = 9;
	pixel_x = -5
	},
/turf/open/floor/carpet/nanoweave/blue,
/area/ship/bridge)
"bf" = (
/obj/machinery/light/directional/north,
/obj/structure/closet/syndicate{
	pixel_y = 10
	},
/obj/item/card/id/syndicate/anyone,
/obj/item/card/id/syndicate/anyone{
	pixel_y = 5
	},
/obj/item/card/id/syndicate/anyone{
	pixel_y = 10
	},
/obj/item/stack/sheet/metal/ten{
	pixel_x = -5
	},
/obj/item/stack/sheet/glass/twenty{
	pixel_x = 3
	},
/turf/open/floor/carpet/nanoweave,
/area/ship/bridge)
"bD" = (
/obj/structure/shuttle/engine/heater,
/obj/structure/window/reinforced/spawner,
/turf/open/floor/plasteel/freezer,
/area/ship/bridge)
"cK" = (
/obj/machinery/suit_storage_unit/standard_unit,
/obj/structure/window/bronze{
	dir = 4
	},
/obj/machinery/light/directional/south,
/turf/open/floor/carpet/nanoweave/red,
/area/ship/bridge)
"cS" = (
/obj/structure/chair/comfy/shuttle/bronze{
	dir = 1;
	pixel_y = 15
	},
/turf/open/floor/carpet/nanoweave/blue,
/area/ship/bridge)
"de" = (
/turf/open/floor/plasteel/freezer,
/area/ship/bridge)
"eI" = (
/obj/structure/table/bronze,
/obj/item/storage/belt/utility{
	pixel_x = 3
	},
/turf/open/floor/carpet/nanoweave/blue,
/area/ship/bridge)
"gb" = (
/turf/open/floor/carpet/nanoweave/red,
/area/ship/bridge)
"gG" = (
/obj/machinery/light/floor,
/turf/open/floor/carpet/nanoweave/blue,
/area/ship/bridge)
"ib" = (
/obj/structure/table/bronze,
/obj/item/storage/firstaid/advanced{
	pixel_x = -1;
	pixel_y = 5
	},
/obj/machinery/light/directional/north,
/turf/open/floor/carpet/nanoweave/blue,
/area/ship/bridge)
"io" = (
/obj/structure/chair/comfy/shuttle/bronze,
/obj/machinery/door/window{
	dir = 1
	},
/turf/open/floor/carpet/nanoweave/beige,
/area/ship/bridge)
"iX" = (
/obj/structure/window/bronze{
	dir = 4
	},
/obj/structure/window/bronze{
	dir = 1
	},
/obj/structure/table/bronze,
/obj/item/encryptionkey/wideband{
	pixel_y = -1;
	pixel_x = 3
	},
/obj/item/encryptionkey/wideband{
	pixel_y = -3;
	pixel_x = -8
	},
/obj/item/encryptionkey/wideband{
	pixel_y = 7;
	pixel_x = -3
	},
/turf/open/floor/carpet/nanoweave/red,
/area/ship/bridge)
"kS" = (
/obj/machinery/light_switch{
	dir = 8;
	pixel_y = 0;
	pixel_x = 20
	},
/turf/open/floor/carpet/nanoweave/orange,
/area/ship/bridge)
"lm" = (
/obj/machinery/atmospherics/components/unary/tank/air,
/obj/structure/curtain/cloth/grey,
/turf/open/floor/plasteel/freezer,
/area/ship/bridge)
"mm" = (
/obj/item/kirbyplants/random{
	pixel_x = -10;
	pixel_y = 20
	},
/turf/open/floor/carpet/nanoweave/blue,
/area/ship/bridge)
"mX" = (
/obj/item/kirbyplants/random{
	pixel_x = -10;
	pixel_y = 5
	},
/turf/open/floor/carpet/nanoweave,
/area/ship/bridge)
"oK" = (
/obj/machinery/power/shuttle/engine/void{
	dir = 1
	},
/turf/open/floor/plating,
/area/ship/bridge)
"pC" = (
/obj/structure/chair/plastic{
	dir = 4;
	pixel_x = 3;
	pixel_y = 1
	},
/turf/open/floor/carpet/nanoweave/orange,
/area/ship/bridge)
"pO" = (
/obj/structure/table/bronze,
/obj/item/pickaxe,
/obj/item/mining_scanner{
	pixel_y = -4;
	pixel_x = -6
	},
/obj/item/storage/bag/ore{
	pixel_x = 5;
	pixel_y = -3
	},
/turf/open/floor/carpet/nanoweave/blue,
/area/ship/bridge)
"pY" = (
/obj/structure/table/bronze,
/obj/item/storage/box/syndie_kit/chameleon{
	pixel_y = 8
	},
/obj/item/storage/box/syndie_kit/chameleon{
	pixel_x = 8;
	pixel_y = -3
	},
/obj/item/storage/box/syndie_kit/chameleon{
	pixel_x = -7
	},
/turf/open/floor/carpet/nanoweave/orange,
/area/ship/bridge)
"rm" = (
/obj/structure/window/bronze,
/obj/structure/table/bronze,
/obj/item/storage/toolbox/mechanical/old/clean{
	pixel_x = -2;
	pixel_y = 6
	},
/turf/open/floor/carpet/nanoweave/blue,
/area/ship/bridge)
"sq" = (
/obj/machinery/door/airlock/external/glass,
/obj/structure/fans/tiny,
/obj/docking_port/mobile{
	can_move_docking_ports = 1;
	launch_status = 0;
	port_direction = 2
	},
/turf/open/floor/carpet/nanoweave/red,
/area/ship/bridge)
"tj" = (
/obj/structure/table/bronze,
/obj/machinery/microwave,
/obj/machinery/light/directional/east,
/turf/open/floor/carpet/nanoweave/orange,
/area/ship/bridge)
"tv" = (
/obj/structure/shuttle/engine/heater,
/obj/structure/window/reinforced/spawner,
/turf/open/floor/carpet/nanoweave/orange,
/area/ship/bridge)
"tL" = (
/turf/template_noop,
/area/template_noop)
"tZ" = (
/obj/machinery/shower{
	dir = 4;
	pixel_x = -10
	},
/obj/structure/curtain,
/obj/machinery/light/directional/south,
/obj/item/soap/syndie{
	pixel_x = -3
	},
/turf/open/floor/plasteel/freezer,
/area/ship/bridge)
"up" = (
/obj/structure/window/bronze,
/turf/open/floor/carpet/nanoweave/blue,
/area/ship/bridge)
"uu" = (
/obj/structure/table/bronze,
/obj/machinery/light/floor,
/obj/item/reagent_containers/food/drinks/mug/tea{
	pixel_x = 9;
	pixel_y = 10
	},
/obj/item/reagent_containers/food/drinks/coffee{
	pixel_y = 2;
	pixel_x = -7
	},
/turf/open/floor/carpet/nanoweave/red,
/area/ship/bridge)
"uS" = (
/obj/structure/window/bronze{
	dir = 4
	},
/turf/open/floor/carpet/nanoweave/red,
/area/ship/bridge)
"vt" = (
/obj/structure/window/bronze{
	dir = 4
	},
/obj/structure/table/bronze,
/obj/item/radio/intercom/directional/west{
	pixel_x = -38;
	dir = 2;
	pixel_y = -17
	},
/obj/item/reagent_containers/food/snacks/donkpocket/warm,
/obj/item/reagent_containers/food/snacks/donkpocket/warm{
	pixel_x = -6;
	pixel_y = 9
	},
/turf/open/floor/carpet/nanoweave/red,
/area/ship/bridge)
"Au" = (
/obj/structure/bed,
/obj/item/bedsheet/syndie,
/obj/structure/curtain/cloth/grey,
/turf/open/floor/carpet/nanoweave,
/area/ship/bridge)
"Ba" = (
/obj/structure/window/bronze{
	dir = 8
	},
/turf/open/floor/carpet/nanoweave/red,
/area/ship/bridge)
"Bm" = (
/obj/structure/tank_dispenser/oxygen,
/obj/structure/window/bronze{
	dir = 8
	},
/obj/machinery/light/directional/south,
/turf/open/floor/carpet/nanoweave/red,
/area/ship/bridge)
"BI" = (
/obj/structure/table/bronze,
/obj/item/trash/plate{
	pixel_x = 2
	},
/obj/item/reagent_containers/food/drinks/mug/tea{
	pixel_x = -3;
	pixel_y = 10
	},
/turf/open/floor/carpet/nanoweave/orange,
/area/ship/bridge)
"EK" = (
/turf/open/floor/carpet/nanoweave,
/area/ship/bridge)
"GQ" = (
/obj/machinery/door/window/westright{
	dir = 2
	},
/turf/open/floor/carpet/nanoweave/blue,
/area/ship/bridge)
"GT" = (
/obj/structure/table/bronze,
/obj/item/trash/plate,
/obj/item/reagent_containers/food/drinks/mug/tea{
	pixel_x = -2;
	pixel_y = 10
	},
/turf/open/floor/carpet/nanoweave/orange,
/area/ship/bridge)
"Hu" = (
/obj/machinery/door/window/westright,
/turf/open/floor/carpet/nanoweave,
/area/ship/bridge)
"HJ" = (
/obj/structure/window/bronze,
/obj/structure/window/bronze{
	dir = 8
	},
/turf/open/floor/carpet/nanoweave/red,
/area/ship/bridge)
"HL" = (
/obj/structure/mirror{
	pixel_y = -30
	},
/obj/structure/sink{
	dir = 1;
	pixel_y = -15;
	pixel_x = -5
	},
/turf/open/floor/plasteel/freezer,
/area/ship/bridge)
"HZ" = (
/obj/machinery/cryopod{
	dir = 4
	},
/turf/open/floor/carpet/nanoweave,
/area/ship/bridge)
"Jz" = (
/obj/machinery/vending/autodrobe/all_access{
	default_price = 0;
	extra_price = 0
	},
/turf/open/floor/carpet/nanoweave,
/area/ship/bridge)
"Kn" = (
/obj/machinery/computer/helm{
	pixel_y = 9
	},
/turf/open/floor/carpet/nanoweave/blue,
/area/ship/bridge)
"Ko" = (
/obj/machinery/light/directional/north,
/obj/machinery/autolathe,
/turf/open/floor/carpet/nanoweave/orange,
/area/ship/bridge)
"Kr" = (
/turf/open/floor/carpet/nanoweave/blue,
/area/ship/bridge)
"KK" = (
/turf/open/floor/carpet/nanoweave/beige,
/area/ship/bridge)
"Lu" = (
/obj/structure/table/bronze,
/obj/item/kitchen/knife{
	pixel_x = -3;
	pixel_y = 2
	},
/turf/open/floor/carpet/nanoweave/orange,
/area/ship/bridge)
"MW" = (
/obj/structure/curtain/cloth/grey,
/obj/structure/table,
/obj/item/reagent_containers/spray/cleaner{
	pixel_y = 5
	},
/turf/open/floor/plasteel/freezer,
/area/ship/bridge)
"Ng" = (
/obj/structure/chair/plastic{
	dir = 4;
	pixel_x = -2;
	pixel_y = 1
	},
/turf/open/floor/carpet/nanoweave/orange,
/area/ship/bridge)
"Nh" = (
/obj/machinery/door/window{
	dir = 4
	},
/turf/open/floor/carpet/nanoweave/orange,
/area/ship/bridge)
"Np" = (
/obj/structure/window/bronze{
	dir = 8
	},
/obj/machinery/jukebox{
	pixel_y = -3;
	pixel_x = 3
	},
/obj/structure/window/bronze{
	dir = 1
	},
/turf/open/floor/carpet/nanoweave/beige,
/area/ship/bridge)
"Ob" = (
/obj/structure/chair/plastic{
	dir = 4;
	pixel_x = 2;
	pixel_y = 4
	},
/turf/open/floor/carpet/nanoweave/orange,
/area/ship/bridge)
"Pd" = (
/obj/machinery/light/floor,
/obj/effect/landmark/observer_start,
/turf/open/floor/carpet/nanoweave/red,
/area/ship/bridge)
"Qw" = (
/obj/structure/window/bronze{
	dir = 1
	},
/obj/structure/toilet{
	dir = 4;
	pixel_x = -5
	},
/turf/open/floor/plasteel/freezer,
/area/ship/bridge)
"QG" = (
/obj/structure/window/bronze{
	dir = 8
	},
/obj/structure/table/bronze,
/obj/item/radio/intercom/wideband/directional/east{
	pixel_x = 45;
	dir = 2;
	pixel_y = -14
	},
/obj/item/toy/plush/lizardplushie{
	pixel_x = 4
	},
/turf/open/floor/carpet/nanoweave/red,
/area/ship/bridge)
"Rj" = (
/obj/machinery/door/window{
	dir = 1
	},
/turf/open/floor/plasteel/freezer,
/area/ship/bridge)
"Tq" = (
/turf/open/floor/carpet/nanoweave/orange,
/area/ship/bridge)
"Ve" = (
/obj/effect/spawner/structure/window/shuttle,
/turf/open/floor/plating,
/area/ship/bridge)
"VS" = (
/obj/machinery/telecomms/allinone{
	pixel_y = 4
	},
/obj/structure/window/bronze,
/turf/open/floor/carpet/nanoweave/blue,
/area/ship/bridge)
"Xu" = (
/obj/effect/spawner/lootdrop/donkpockets,
/obj/effect/spawner/lootdrop/donkpockets,
/obj/structure/closet/secure_closet/freezer{
	pixel_y = -7
	},
/obj/effect/spawner/lootdrop/donkpockets,
/obj/effect/spawner/lootdrop/donkpockets,
/turf/open/floor/carpet/nanoweave/orange,
/area/ship/bridge)
"Ya" = (
/obj/machinery/door/window/westright{
	dir = 2
	},
/obj/structure/chair/comfy/teal{
	dir = 1
	},
/obj/machinery/holopad/emergency/clown,
/turf/open/floor/carpet/nanoweave/red,
/area/ship/bridge)
"Yx" = (
/turf/closed/wall/mineral/titanium/nodiagonal,
/area/ship/bridge)
"Zp" = (
/obj/structure/window/bronze{
	dir = 1
	},
/obj/structure/curtain/cloth/grey,
/obj/structure/table,
/obj/item/disk/nuclear/fake{
	pixel_x = -4
	},
/turf/open/floor/plasteel/freezer,
/area/ship/bridge)

(1,1,1) = {"
tL
tL
tL
tL
tL
tL
Yx
Ve
Ve
Ve
Yx
tL
tL
"}
(2,1,1) = {"
tL
tL
tL
tL
Yx
Ve
Yx
HZ
Qw
HL
Yx
Yx
tL
"}
(3,1,1) = {"
tL
Yx
Ve
Ve
Yx
bf
mX
EK
Rj
de
tZ
Yx
Yx
"}
(4,1,1) = {"
Yx
Yx
ib
eI
rm
Au
EK
Jz
Zp
MW
lm
bD
oK
"}
(5,1,1) = {"
Ve
aA
mm
Kr
up
Ba
Hu
Ba
Np
QG
HJ
Bm
Yx
"}
(6,1,1) = {"
Ve
Kn
cS
gG
GQ
Kr
Pd
KK
io
uu
Ya
gb
sq
"}
(7,1,1) = {"
Ve
aW
Kr
Kr
up
uS
Nh
uS
iX
vt
az
cK
Yx
"}
(8,1,1) = {"
Yx
Yx
aw
pO
VS
pY
Tq
Tq
Tq
Tq
Xu
tv
oK
"}
(9,1,1) = {"
tL
Yx
Ve
Ve
Yx
Ko
kS
pC
Ng
Ob
tj
Yx
Yx
"}
(10,1,1) = {"
tL
tL
tL
tL
Yx
Ve
Yx
GT
BI
Lu
Yx
Yx
tL
"}
(11,1,1) = {"
tL
tL
tL
tL
tL
tL
Yx
Ve
Ve
Ve
Yx
tL
tL
"}
